4 10
6 3
5 7
5 3
2 6
  1 47 26 12 19  8  2 12  7  3
  4 32 24  3 45  1 32 23  2  3
  2 25 28 13  1 12 39 44  1  2
  5 19 26 17 14  3 28 30 18  2
  3 14 16  1 17 20 36 21  2  6
  4 12 13  5 28 40 60 70  4  6
  5  9  3 13 42 60 81 19  5  6
  3  4  1 18 55 74  3 19  1  4
  6  5 17 34 79  3 11 19  5  5
  6  5  8  5 26 14 11 21  4  6
